╔════════════════════════╗             ╔════════════════════════════╗       ╔═════════════════════╗           ╔═══════════════════════════════════════════════╗
║                        ║             ║                            ║       ║                     ║           ║                                               ║
║                        ║             ║                            ║       ║                     ║           ║                                               ║
║                        ╚═════════════╝                            ║       ║                     ║           ║                                               ║
║                        \             \                            ╚═══════╝                     ╚═══════════╝                                               ║
║                        ╔═══╗/\╔══════╗                            /       /                     /           /                                               ║
║                        ║   ║  ║      ║                            ╔═══════╗                     ╔═══════════╗                                               ║
║                        ║   ║  ║      ║                            ║       ║                     ║           ║                                               ║
║                        ║   ║  ║      ║                            ║       ║                     ║           ║                                               ║
╚════════════════════════╝   ║  ║      ║                            ║       ╚═════════════════════╝           ║                                               ║
                             ║  ║      ║                            ║                                         ║                                               ║
                             ║  ║      ║                            ║                                         ║                                               ║
                             ║  ║      ║                            ║                                         ║                                               ║
                             ║  ║      ╚════════════════════════════╝                                         ║                                               ║
                             ║  ║                                                                             ║                                               ║
                             ║  ║                                                                             ║                                               ║
                             ║  ║                                                                             ║                                               ║
                         ╔═══╝/\╚═══════════╗                                                                 ║                                               ║
                         ║                  ║                                                                 ║                                               ║
                         ║                  ║                                                                 ║                                               ║
                         ║                  ║                                                                 ║                                               ║
                         ║                  ║                                                                 ║                                               ║
                         ║                  ║                                                                 ║                                               ║
                         ║                  ║                                                                 ║                                               ║
                         ║                  ║                                                                 ║                                               ║
                         ║                  ║                                                                 ║                                               ║
                         ║                  ║                                                                 ║                                               ║
                         ║                  ║                                                                 ║                                               ║
                         ║                  ║                                                                 ║                                               ║
                         ║                  ║                                                                 ║                                               ║
                         ║                  ║                                                                 ║                                               ║
                         ╚══════════════════╝                                                                 ║                                               ║
                                                                                                              ║                                               ║
                                                                                                              ║                                               ║
                                                                                                              ╚══════════════════════╗     ╔══════════════════╝
                                                                                                                                     ║     ║
                                                                                                                               ╔═════╝     ╚══════╗
                                                                                                                               ║                  ║
                                                                                                                               ║                  ║
                                                                                                                               ║                  ║
                                                                                                                               ║                  ║
                                                                                                                               ║                  ║
                                                                                                                               ╚══════════════════╝
